**** *****
*  *  *  *
**       *
****  ** *
*  **   **
*  *  *  *
*     *  *
****  ** *
*        *
*** ******
