**** ****
**      *
** **** *
**      *
** * ****
** *   **
** *** **
**     **
** ******
